20 20
00000000000000000000
0        0         0
0    000 0         0
0        0    0    0
0      000    0    0
0  0     0         0
0  0     0         0
000000   0         0
     0   0         0
000000             0
0        0000000   0
0        0         0
0    000 0         0
0        0         0
0      000         0
0  0     0         0
0  0   0 0         0
0 0000 0 0         0
0        0         0
00000000000000000000
